1111111
1P00001
1010101
1A001E1
1010101
1C00001
1111111
