1111111
1P00001
1111101
1000101
1C011E1
1000001
1111111
