111111
1P00C1
1000C1
1C0E1
111111
