1111111111
1P0000C001
1011110101
1C00000101
1010111011
1000100001
1C0101C001
1010000101
10000000E1
1111111111
