1111111111111111
1P0000000C000011
1010111110101011
1C00010000100011
1011101011101011
100000C00X010001
1110111010111011
1C000000000000C1
1010111011101011
100010X000100011
1011110111111011
1C0000000C0000E1
1010111010111101
1C00000X00000001
1111111111111111
